Rank,Country,Code,Gold.Men,Silver.Men,Bronze.Men,Men.Total,Gold.Women,Silver.Women,Bronze.Women,Women.Total,Gold.Open.Mixed,Silver.Open.Mixed,Bronze.Open.Mixed,Open.Mixed.Total,Gold.Total,Silver.Total,Bronze.Total,Total,RankbyTotal,Population
1,China,CHN,24,10,8,42,27,11,19,57,0,0,1,1,51,21,28,100,2,1325861000
2,UnitedStates,USA,20,13,20,53,15,23,15,53,1,2,1,4,36,38,36,110,1,305020000
3,RussianFed,RUS,12,8,20,40,11,13,8,32,0,0,0,0,23,21,28,72,3,141888900
4,GreatBritain,GBR,11,8,7,26,7,5,6,18,1,0,2,3,19,13,15,47,4,60975000
5,Germany,GER,7,7,6,20,6,2,7,15,3,1,2,6,16,10,15,41,6,82191000
6,Australia,AUS,6,6,9,21,8,7,8,23,0,2,0,2,14,15,17,46,5,21407290
7,SouthKorea,KOR,8,6,4,18,4,4,4,12,1,0,0,1,13,10,8,31,8,48224000
8,Japan,JPN,4,4,5,13,5,2,5,12,0,0,0,0,9,6,10,25,11,127690000
9,Italy,ITA,4,7,6,17,4,3,4,11,0,0,0,0,8,10,10,28,9,59619290
10,France,FRA,6,14,12,32,1,2,4,7,0,0,1,1,7,16,17,40,7,64473140
11,Ukraine,UKR,4,3,8,15,3,2,7,12,0,0,0,0,7,5,15,27,10,46059306
12,Netherlands,NED,1,0,2,3,5,4,2,11,1,1,0,2,7,5,4,16,16,16448000
13,Jamaica,JAM,3,0,0,3,3,3,2,8,0,0,0,0,6,3,2,11,20,2714000
14,Spain,ESP,4,6,2,12,0,3,1,4,1,1,0,2,5,10,3,18,14,46063500
15,Kenya,KEN,3,2,4,9,2,3,0,5,0,0,0,0,5,5,4,14,18,37538000
16,Belarus,BLR,3,3,5,11,1,2,5,8,0,0,0,0,4,5,10,19,13,9690000
17,Romania,ROU,0,0,1,1,4,1,2,7,0,0,0,0,4,1,3,8,25,21438000
18,Ethiopia,ETH,2,1,1,4,2,0,1,3,0,0,0,0,4,1,2,7,27,79221000
19,Canada,CAN,1,5,3,9,1,3,3,7,1,1,0,2,3,9,6,18,14,33362600
20,Poland,POL,3,4,0,7,0,2,1,3,0,0,0,0,3,6,1,10,21,38115967
21,Hungary,HUN,2,4,1,7,1,1,1,3,0,0,0,0,3,5,2,10,21,10043000
21,Norway,NOR,2,3,0,5,1,2,1,4,0,0,1,1,3,5,2,10,21,4780000
23,Brazil,BRA,1,3,5,9,2,1,3,6,0,0,0,0,3,4,8,15,17,190044000
24,CzechRepublic,CZE,1,2,0,3,2,1,0,3,0,0,0,0,3,3,0,6,30,10403136
25,Slovakia,SVK,2,1,1,4,1,1,0,2,0,0,0,0,3,2,1,6,30,5402273
26,NewZealand,NZL,1,1,5,7,2,0,0,2,0,0,0,0,3,1,5,9,24,4276100
27,Georgia,GEO,3,0,2,5,0,0,1,1,0,0,0,0,3,0,3,6,30,4395000
28,Cuba,CUB,2,5,8,15,0,6,3,9,0,0,0,0,2,11,11,24,12,11268000
29,Kazakhstan,KAZ,2,2,5,9,0,2,2,4,0,0,0,0,2,4,7,13,19,15422000
30,Denmark,DEN,1,2,1,4,0,0,1,1,1,0,1,2,2,2,3,7,27,5489022
31,Mongolia,MGL,2,1,0,3,0,1,0,1,0,0,0,0,2,2,0,4,44,2629000
31,Thailand,THA,1,1,0,2,1,1,0,2,0,0,0,0,2,2,0,4,44,63038247
33,NorthKorea,PRK,0,0,1,1,2,1,2,5,0,0,0,0,2,1,3,6,30,23790000
34,Argentina,ARG,2,0,1,3,0,0,2,2,0,0,1,1,2,0,4,6,30,40454000
34,Switzerland,SUI,2,0,3,5,0,0,1,1,0,0,0,0,2,0,4,6,30,7647600
36,Mexico,MEX,1,0,0,1,1,0,1,2,0,0,0,0,2,0,1,3,51,106682500
37,Turkey,TUR,1,0,3,4,0,4,0,4,0,0,0,0,1,4,3,8,25,70586256
38,Zimbabwe,ZIM,0,0,0,0,1,3,0,4,0,0,0,0,1,3,0,4,44,13349000
39,Azerbaijan,AZE,1,2,3,6,0,0,1,1,0,0,0,0,1,2,4,7,27,8467000
40,Uzbekistan,UZB,1,2,2,5,0,0,1,1,0,0,0,0,1,2,3,6,30,27372000
41,Slovenia,SLO,1,1,1,3,0,1,1,2,0,0,0,0,1,2,2,5,38,2029000
42,Bulgaria,BUL,0,0,3,3,1,1,0,2,0,0,0,0,1,1,3,5,38,7640238
42,Indonesia,INA,1,0,2,3,0,0,1,1,0,1,0,1,1,1,3,5,38,231627000
44,Finland,FIN,0,0,2,2,1,1,0,2,0,0,0,0,1,1,2,4,44,5318105
45,Latvia,LAT,1,1,1,3,0,0,0,0,0,0,0,0,1,1,1,3,51,2268000
46,Belgium,BEL,0,0,0,0,1,1,0,2,0,0,0,0,1,1,0,2,57,10666866
46,DominicanRep.,DOM,1,1,0,2,0,0,0,0,0,0,0,0,1,1,0,2,57,9760000
46,Estonia,EST,1,1,0,2,0,0,0,0,0,0,0,0,1,1,0,2,57,1340600
46,Portugal,POR,1,0,0,1,0,1,0,1,0,0,0,0,1,1,0,2,57,10623000
50,India,IND,1,0,2,3,0,0,0,0,0,0,0,0,1,0,2,3,51,1137467400
51,Iran,IRI,1,0,1,2,0,0,0,0,0,0,0,0,1,0,1,2,57,70495782
52,Bahrain,BRN,1,0,0,1,0,0,0,0,0,0,0,0,1,0,0,1,69,760168
52,Cameroon,CMR,0,0,0,0,1,0,0,1,0,0,0,0,1,0,0,1,69,18549000
52,Panama,PAN,1,0,0,1,0,0,0,0,0,0,0,0,1,0,0,1,69,3343000
52,Tunisia,TUN,1,0,0,1,0,0,0,0,0,0,0,0,1,0,0,1,69,10327000
56,Sweden,SWE,0,2,1,3,0,1,0,1,0,1,0,1,0,4,1,5,38,9215021
57,Croatia,CRO,0,1,0,1,0,1,3,4,0,0,0,0,0,2,3,5,38,4555000
57,Lithuania,LTU,0,1,3,4,0,1,0,1,0,0,0,0,0,2,3,5,38,3361100
59,Greece,GRE,0,2,0,2,0,0,2,2,0,0,0,0,0,2,2,4,44,11147000
60,TrinidadTobago,TRI,0,2,0,2,0,0,0,0,0,0,0,0,0,2,0,2,57,133300
61,Nigeria,NGR,0,1,1,2,0,0,2,2,0,0,0,0,0,1,3,4,44,148093000
62,Austria,AUT,0,1,0,1,0,0,2,2,0,0,0,0,0,1,2,3,51,8340924
62,Ireland,IRL,0,1,2,3,0,0,0,0,0,0,0,0,0,1,2,3,51,4422100
62,Serbia,SRB,0,1,2,3,0,0,0,0,0,0,0,0,0,1,2,3,51,9858000
65,Algeria,ALG,0,1,0,1,0,0,1,1,0,0,0,0,0,1,1,2,57,33858000
65,Bahamas,BAH,0,1,1,2,0,0,0,0,0,0,0,0,0,1,1,2,57,331000
65,Colombia,COL,0,1,0,1,0,0,1,1,0,0,0,0,0,1,1,2,57,44513090
65,Kyrgyzstan,KGZ,0,1,1,2,0,0,0,0,0,0,0,0,0,1,1,2,57,5317000
65,Morocco,MAR,0,1,0,1,0,0,1,1,0,0,0,0,0,1,1,2,57,31224000
65,Tajikistan,TJK,0,1,1,2,0,0,0,0,0,0,0,0,0,1,1,2,57,6736000
71,Chile,CHI,0,1,0,1,0,0,0,0,0,0,0,0,0,1,0,1,69,16763470
71,Ecuador,ECU,0,1,0,1,0,0,0,0,0,0,0,0,0,1,0,1,69,13341000
71,Iceland,ISL,0,1,0,1,0,0,0,0,0,0,0,0,0,1,0,1,69,319355
71,Malaysia,MAS,0,1,0,1,0,0,0,0,0,0,0,0,0,1,0,1,69,27170000
71,SouthAfrica,RSA,0,1,0,1,0,0,0,0,0,0,0,0,0,1,0,1,69,47850700
71,Singapore,SIN,0,0,0,0,0,1,0,1,0,0,0,0,0,1,0,1,69,4588600
71,Sudan,SUD,0,1,0,1,0,0,0,0,0,0,0,0,0,1,0,1,69,38560000
71,Vietnam,VIE,0,1,0,1,0,0,0,0,0,0,0,0,0,1,0,1,69,87375000
79,Armenia,ARM,0,0,6,6,0,0,0,0,0,0,0,0,0,0,6,6,30,3002000
80,ChineseTaipei,TPE,0,0,2,2,0,0,2,2,0,0,0,0,0,0,4,4,44,23000000
81,Afghanistan,AFG,0,0,1,1,0,0,0,0,0,0,0,0,0,0,1,1,69,27145000
81,Egypt,EGY,0,0,1,1,0,0,0,0,0,0,0,0,0,0,1,1,69,75264000
81,Israel,ISR,0,0,1,1,0,0,0,0,0,0,0,0,0,0,1,1,69,7303000
81,Rep.ofMoldova,MDA,0,0,1,1,0,0,0,0,0,0,0,0,0,0,1,1,69,3794000
81,Mauritius,MRI,0,0,1,1,0,0,0,0,0,0,0,0,0,0,1,1,69,3124000
81,Togo,TOG,0,0,1,1,0,0,0,0,0,0,0,0,0,0,1,1,69,6585000
81,Venezuela,VEN,0,0,0,0,0,0,1,1,0,0,0,0,0,0,1,1,69,27953701
